00000000000000000000
00000000000000000000
00000011100000000000
00000002200000000000
00100000000001100000
11211111111112211111
22222222222222222222
02222222222222222222
02200222202022022202
02000020000020020200
