0000000000000000000000000000000000000000
0000000000000000000000000000000000000000
0000001110000000000000000011100000000000
0000000220000000000000000002200001101000
0010000000000110000000100000000000200000
1121111111111221111100000000000000000010
2222222222222222222200110000000000001000
0222222222222222222200221000000000100000
0220022220202202220200000011111110000000
0200002000002002020000000002222200000000
